205, 451
422, 488, 140
208, 91, 188, 124
182, 359, 495, 367, 324
61, 307, 84, 550, 52, 322
186, 555, 254, 60, 145, 133, 206
541, 320, 313, 21, 515, 197, 511, 29
437, 573, 408, 174, 324, 520, 268, 277, 379
519, 216, 73, 82, 375, 129, 439, 560, 379, 550
504, 80, 252, 448, 97, 284, 571, 89, 556, 87, 599
454, 386, 215, 557, 584, 236, 71, 325, 528, 85, 163, 463
573, 74, 397, 96, 324, 348, 308, 413, 81, 467, 8, 166, 225
319, 211, 569, 77, 599, 39, 217, 179, 56, 335, 41, 446, 404, 216
398, 435, 581, 252, 343, 299, 466, 430, 40, 76, 352, 79, 574, 51, 362